wwwwwwwwwwwwwwwwwww
w,,,,,,,,g,,,,,,,,w
wwwwwwww...wwwwwwww
we.e.e.ee.ee.e.e.ew
w.................w
we.e.e.ee.ee.e.e.ew
w.................w
w.................w
we.e.e.ee.ee.e.e.ew
we,,,,,,,A,,,,,,,ew
wwwwwwwwwwwwwwwwwww