wwwwwwwwwwwwwwwwwwwwwwwwwwwww
w...3........c..............w
w.tttttttt.......t....5.....w
w......t.....ttt............w
w...c..t..........ttttttttt.w
w......t.................c..w
w......t.....C......tttt....w
w.ttt.......................w
w........t........t.........w
w........t..ttt...t...tttt..w
w....6...t........t.........w
w........t...c....t....4....w
w............tt.............w
wwwwwwwwwwwwwwwwwwwwwwwwwwwww