wwwwwwwwwwwwwwwwwwwwwwwwwwwwwwwwwwwwwwwwwwwwwwww
wg............................................sw
wg............................................rw
wg............................................Bw
wg............................................rw
wg............................................rw
wg............................................mw
wg............................................fw
wwwwwwwwwwwwwwwwwwwwwwwwwwwwwwwwwwwwwwwwwwwwwwww