wwwwwwwwwwwwwwwwwwwwwwwwwwww
w0................w........w
w......h...w......w....0...w
w..........w..0...h........w
w.....wwwwwwwwwwwwwwwwww...w
w.A..........h.........w.1.w
w.....wwwwwwwwwwwwwwwwww...w
w..........w..0............w
w..........w......w....0...w
w0.........h......w........w
wwwwwwwwwwwwwwwwwwwwwwwwwwww
