wwwwwwwwwwwwwwww
w..w...w...w...w
w......w.......w
w..w...w...w...w
w..w.......w...w
wg.w...w...w.A.w
wwwwwwwwwwwwww.w
wf.............w
wwwwwwwwwwwwwwww
