wwwwwwwwwwwwwwwwwwwwwwwwwwww
wA.......e.................w
w..0.......0....0......e...w
w........wwwwwwwwww........w
w....0...w..x.....w......0.w
w........w........w...0....w
w...0..0.w.....x..wwww.wwwww
w....0...wwwwwwwwww........w
w..............w...x...0...w
w.....0..e......0..0......xw
wwwwwwwwwwwwwwwwwwwwwwwwwwww
