wwwwwwwwwwwwwwwwwwwwwwwwwwww
w.............d.wAd........w
w.............g.w........b.w
wwwwww...wwwwwbwwwww.......w
w........w.........w.......w
w.b...........lr...........w
w........w....d....w.......w
w........wwwww.wwwwwwwww.www
w.........................lw
w..........................w
wwwwwwwwwwwwwwwwwwwwwwwwwwww
