wwwwwwwwwwwwwwwwwwwwwwwwwwww
w.....te...................w
w.......s..................w
w..........................w
wwwwww.....................w
w....e...w....b............w
w........w...bAb.........d.w
www......w....b............w
wgo......w............t....w
www......w...........m.s...w
wwwwwwwwwwwwwwwwwwwwwwwwwwww
