wwwwwwwwwwwwwwwwwwwwwwwwwwww
w...............w.d........w
w.A.............w.g........w
wwwwww...wwwwwbwwwww.......w
w........w.........w.......w
w.............lr...........w
w........w....d....w.......w
w........wwwww.wwwwwwwwww.ww
w..........................w
w..........................w
wwwwwwwwwwwwwwwwwwwwwwwwwwww
