wwwwwwwwwwwwwwwwwwwwwwwwwwww
w..............w..w........w
w..............w...........w
w..............w.ww...d....w
w..............o..w........w
w..............o...........w
w.......A......w...........w
w.........l....w..w........w
w..............woww........w
w..t...........wgww........w
wwwwwwwwwwwwwwwwwwwwwwwwwwww
