wwwwwwwwwwwwwwwwwww
wA+0+w0+0+00+0+0++w
w++..w........+0++w
w++++w......++0+0+w
w++++w.....+++++0+w
w++0+0++.+++0+1++ww
w++++0++++++00+++ww
wwwwww++++0++++++ww
w++++0++.....++...w
w++0++0+0s......0gw
wwwwwwwwwwwwwwwwwww
