wwwwwwwwwwwwwwwwwww
wA++.++0+++++..++gw
w0++.++++++++..++0w
wwwww++++++0+wwwwww
w+++++w++++++++w+0w
w+0+++wwwwwww++++ww
w++0++++++0++0+0++w
wwwww+++++www++++0w
w000++++++0++++0+1w
w000w+++s++++0++www
wwwwwwwwwwwwwwwwwww
