wwwwwwwwwwwwwwwwwwww
w................h.w
w.....h......rr....w
w..................w
w.........A....rr..w
w.h...........rrr..w
w..................w
w...rr....n.....h..w
w...rr.............w
w....r.......rrr...w
w...........rr.....w
w..............h...w
w......h..r........w
w..................w
wwwwwwwwwwwwwwwwwwww
