wwwwwwwwwwwwwwwwwwww
w....n.......A.....w
w.........r......h.w
w..................w
w.................hw
w....r.......r.....w
w........h.........w
w............rrrr..w
w.............r....w
w.......h........h.w
w.............r....w
w...........rrrr...w
w.........h........w
w..................w
wwwwwwwwwwwwwwwwwwww
