aaaaaaaaaaaaaaaaaaaaa
.....................
....................1
2....................
.............A......1
2....................
....................1
2....................
......3.......3......