w1w0w1ww0ww00w
ww0w1www0ww1w0
wAwww1w0w0www1
0www0www2w0w0w
ww1www0ww1w0w0