w1w0www0w1w0ww
wAww0w0w1w0www
ww00w1ww0ww1w0
ww0ww0w1w0ww2w
w1ww0ww0ww10ww