ww0w1ww0ww1w0w
0www0ww0ww0ww1
ww0Aw1w0www20w
0w1ww0w1ww0www
ww0w1ww0www0w1