wwwwwwwwwwwww
wA...e...w..w
w..w........w
w...w...w.+ww
www.w2..wwwww
w.......w.g.w
w.2.........w
w.....2.....w
wwwwwwwwwwwww
